000000041111111
000000041111111
000000041111111
000000041111111
000003333311111
000003333311111
000003333311111
111113333300000
111113333300000
111111140000000
111111140000000
111111140000000
111111140000000
111111140000000
111111140000000

