000000041111111
000000041111111
000000041111111
000000041111111
000022222221111
000022222221111
000022222221111
111122222220000
111122222220000
111122222220000
111111140000000
111111140000000
111111140000000
111111140000000
111111140000000

