000000041111111
000000041111111
000000041111111
000000041111111
000033333331111
000033333331111
000033333331111
111133333330000
111133333330000
111133333330000
111111140000000
111111140000000
111111140000000
111111140000000
111111140000000

