0000000441111111
0000000441111111
0000000441111111
0000000441111111
0000222222211111
0000222222211111
0000111111111111
1111111111111111
1111111111100000
1111111111100000
1111222222200000
1111222222200000
1111111440000000
1111111440000000
1111111440000000
1111111440000000
